NO texture/image1.xpm
SO texture/image1.xpm
WE texture/image1.xpm
EA texture/image1.xpm

F 80,188,223
C 225,30,0

        1111111111111111111111111
        1000000000110000000111011
        1011000001110000000110001
        1001000000000000000110001
111111111011000001110000000000001
100000000011000001110111111111111
11110111111111011100000010001
11110111111111011101010010001
11000000110101011100000010001
10000000000000001100000000001
10000000000000001101010010101
11000001110101011111011111N1111
11110111 1110101 101111010101
11111111 1111111 111111111111