NO texture/image1.xpm
SO texture/image1.xpm
WE texture/image1.xpm
EA texture/image1.xpm

F 80,188,223
C 225,30,0

       11111111111
1111111100000000011111111     111111111
100000000011000000000000111   100000001
1011000001110000N000010001     111111111
1001000000000000000110001
1111111111111111111111111