NO ./image1.xpm
SO ./image1.xpm
WE ./image1.xpm
EA ./image1.xpm

F 220,100,0
C 225,30,0

       11111111111
1111111100000000011111111     111111111
100000000011000000000000111   100000001
101100000111000S000010001     111111111
1001000000000000000110001
1111111111111111111111111