NO texture/image1.xpm
SO texture/image1.xpm
WE texture/image1.xpm
EA texture/image1.xpm

F 80,188,223
C 225,30,0

1111111111111
1000000000001
100000S000001
1000000000001
1111111111111

1111111111111
1111111111111
