NO ./image1.xpm
SO ./image1.xpm
WE ./image1.xpm
EA ./image1.xpm

F 220,100,0
C 225,30,0

1111111111111111111111111     111111111
1000000000110000000000001     100000001
101100000111000S000010001     111111111
1001000000000000000110001
1111111111111111111111111